+~+~+~+~+~+~+~+~+~+~+~+~+~+~+~+~+~+~+~+~|
|         |     |       |           |   |
+ +~+~+~+ + +~+ + +~+~+~+ +~+~+ +~+ + +~|
|       |   |   |   |   | |     |     | |
+~+~+~+ +~+~+~+ +~+ + + + + +~+~+~+~+ + |
|   |   |     |     | |   | |   |   | | |
+ + + +~+~+ +~+ +~+~+ +~+~+ +~+ + + + + |
| |   |       |   | |   | | |   | | |   |
+ +~+~+~+~+~+ +~+ + +~+ + + +~+ + + +~+ |
|   |           | |   | | |   |   |   | |
+~+ +~+~+~+~+~+ + + + + + +~+ +~+~+ +~+ |
|   | |   |   |   | | |   | |   |     | |
+ +~+ + + + + + +~+~+ +~+ + +~+ + +~+~+ |
| |   | |   |         |   |   | |     | |
+ + +~+ +~+~+~+~+~+~+~+ +~+ +~+ + + +~+ |
| | |   |         |     |     | | |   | |
+ + + +~+ +~+~+ +~+ +~+~+~+ +~+ +~+ + + |
| |   |   |   |     |         |   | | | |
+ +~+~+ +~+ +~+~+~+~+~+~+ +~+~+~+ +~+ + |
|                               | |     |
+~+~+~+~+~+~+~+~+~+~+~+~+~+~+~+~+~+~+~+~|
